wwwwwwwwwwwwwwww
w.xww.........xw
w.w.w.www....www
www.txw......www
www.www.ww.w.www
wwwwwww....wA..w
wwwwwww...ww.www
wwtww.w......ttw
ww.w.....w...w.w
w.......www.ww.w
w......wwww..w.w
w....www.....txw
ww...www.....www
wwwwwwwwwwwwwwww
