.............
w............
w.0..........
........w....
......A......
.............
............0
.............
