..............w.....
...........w..0.....
....w0..............
.........A.0........
..w.........0.......
.w......w...........
......0..w..........
.....w..............
