wwwwww-wwwwxwwwwwwwwwwwwww
w..--c-o.w..o..-..co.oxo.w
w..---w....x....e.......ww
w..oxxo....x............xw
w.o......ocoo.....o-x..-.w
w.--b--...xxx.........oc.w
w.o.x..w.....b.x.....oxw-w
w......................xxw
w...o.xo......ox--.......w
w.oA..........x-bo....-..w
w...-o...oo.--.o.-.......w
wx..xx..o.x...w......xx..c
wwwwwwwwwwwwwwwwwwwwwwwwww
