......0w7....
.............
.............
....7........
......A......
...0.........
....0........
.............
