....................
......7.............
.......0............
.........A..........
.....w..............
....................
.0.........0......0.
.........0..........
