............0........0........
.00.....0...0........2........
..0.................w0..0.....
..w............w..........0...
..............................
..0........w..................
..........................10..
....0....0...000000......0....
...00.0.....000000..0.0000000.
...0...0.....0....00.0..0000..
.2..............A...0....0....
