wwwwwwwwwwwwwwwwwwwwwwwwwwww
w....A...w.0.........w..0..w
w........wh..w.............w
w.h...w.0w........w....w...w
w........w........w....w..0w
w..0.....w....h...w....w..hw
w...ww...w........w....w...w
w........w........w...0w...w
w....0.............0..w....w
w........h.......0w.0..1...w
wwwwwwwwwwwwwwwwwwwwwwwwwwww
