wwwwwwwwwwwwwwwwwwwwwwwwww
w.c--c-.....o......-ooxoow
wo.--ob....x....o...x...xw
w...xx....o..............w
w.w......oxoe.....--c-...w
w.--b.-o.xxxx..o.....oo.ew
w..x.....-...........x.o.w
w....w....-o..o...-....-xw
w.....xxx.....o---...xo.bw
w..x-...e.....x-.x....o..w
w....e...oo....-.o-.o....w
w...xx...xA..........xx..w
wwwwwwwwwwwwwwwwwwwwwwwwww
