....................
..........w.......w.
.................0..
......w..0.........0
...w....0.......0...
.....ww........0....
.................0..
..0..0....0......0..
