1......0......................
000........0................1.
000...............0...........
.................0............
......0....0....0...w.........
....2.........................
..............................
.0..00.......000000..0..00....
....0000....00000.00...00000..
...0...0....00....0.....0000..
w...............A.............
