...........0........
....................
....................
.........A..........
............0.......
..0........0........
....................
.......w....0w......
