1..........w...0..............
000....w....................0.
0.0......................0....
...0w.........................
....0......01............0....
..............................
0.............................
....000w.....000000.....000...
...00.00.....00.0000....0.00..
...0...0....0.....00.0.00000..
................A.............
