wwwwwwwwwwwwwwwwwwwwwwwwww
w..--c-..w..o......oooxo.w
w..----....x....e...-...xw
w..oxxo....x............xw
w.o......o.oo.....o-c..-.w
w..-b--...xxx.........o..w
w.x.x..w....wb.x......xo-w
w......o...............xxw
w...o.x.x.....ox--...o...w
w..A..........x-b-....o..w
w...-o...oo..-.o--......xw
w...xx....x...w......xx..w
wwwwwwwwwwwwwwwwwwwwwwwwww
