wwwwwwwwwwwwwwwwwwwwwwwwww
w..--c-o.w..o..-..co.oxo.w
w..----....x....e.......xw
w..oxxo....x............xw
w.o......o.oo.....o-x..-.w
w.--b--...xxx.........oc.w
w.o.x..w.....b.x.....oxc-w
w......................xxw
w...o.xox.....ox--.......w
w..A..........x-bo....-..w
w...-o...oo..-.o--.......w
w...xx....x...w......xx..w
wwwwwwwwwwwwwwwwwwwwwwwwww
