wwwwwwwbww..wwwwwxwwwwwwww
w...-co-xo.x-........oxooA
w..----.......o....ox...xw
w..oxxo.w..........o..-..-
w-.......oo-......b-.b...w
w.--c--..xxxx...x....oob.w
w..wx.w...o.....o.....xo.w
w..o...e...e....c...e..xxw
w..w..........o.-o.o.o...w
w..w..-w...x..xwb-....o..w
....owc..ow...o--xx.-....w
wb..x-e..xx..x..w..x.xx...
wwwwwwwwwwwwwwwwwwwwwb.www
