1.............................
00.............0..............
000...........................
..............................
................0.............
..............................
..............................
....000......0000w0......00...
...00000....00000000...00000..
...0...0....00....00...00000..
................A...........0.
