wwwwwwwwwwwwwwwwwwwwwwwwww
w..--c-............-ooxoow
we.--o-....o....o.-.x...xw
w...xx....o..............w
w.w.....-oxoe.....--c-...w
w.--b.-..xxxx..o.....oo.ow
w..x........x........xxo.w
w....w.....o..o...-o...-xw
w.....xxx.....o--.....o..w
w..x....e.....x-bx....o..w
w....e...oo....-.o-.o....w
w...xx...xA..........xx..w
wwwwwwwwwwwwwwwwwwwwwwwwww
