10w.............6.............
000......6....0...............
00..........................0.
...0....................6.....
.......00.0........000........
.......0..0........0..0.......
....................2.........
..............................
..00000....00000000....00000..
..0...0....00....00....00000..
...............A1.............
