...........0........
....................
.........w...w......
.........A..........
............0.......
..0........0........
............ww......
.....w......0.......
