1.....2......................0
000..0........................
000...........................
..............................
..............................
.............................w
..............................
....000......000000.....000...
...00000....00000000...00000..
...0...0....00..1.0....00000..
................A.............
