1......0......................
000........0................1.
000...........................
..............................
...........0....0.............
..............................
..............................
....00.......000000..0..000...
...00000....00000000...00000..
...0...0....00....00....0000..
w...............A.............
