......0......
.....w..w....
..w..........
........0.0..
w.....A......
.............
.............
..0..........
