.............0......
......00..........w.
....................
.........A.w........
...........0........
....................
....................
......0.............
