wwwwwwwwwwwwwwwwwwwwwwwwww
w....c-.x......-...-ooxoow
we.--o-....o....o--xxw..xw
w...xx....o......e.......w
w.w.....-oxoe.....--c-...w
w.e-b.-..x.xx..o......o.ow
w..x........x-..o....xxo.w
w....ww....o..o...-o...-xw
w......xx......--.....o..w
w.......e.....x-bx.x..o..w
w....e...oo..o.-oo..o.-b.w
w...xx...xA..........xx..w
wwwwwwwwwwwwwwwwwwwwwwwwww
