...........0..0..0..
....................
.........w..........
.........A...w......
............0..w....
6.0........w........
..........6.........
6...................
