..00................
w.........0.........
..................0.
.........A.w.....w..
....................
...w................
....................
w..................0
