.............
w............
w.0..........
w.......w....
......A......
.............
........0...0
.............
