wwwwwwwwwwwwwwwwwwwwwwwwww
w..--c-e...........-oo.oow
we.--o-....o....o.-.x...xw
w...xx....o..............w
w.w.....-oxoe.....--c-...w
w.--b.-..xxxx..o.....oo.ow
w..x........x......w.xxo.w
w....w..b..o..o...-o...-xw
w.....xxx.....o--.....o..w
w..x....e.....x-bx..x.o..w
w...-e...oo....-.o-.o....w
w...xx...xA..........xx..w
wwwwwwwwwwwwwwwwwwwwwwwwww
