1.............................
.00...........................
000...........................
..............................
..............................
................0.............
..............................
....200......000000.....0002..
...00000....00000000...00000..
...0...0....00....00...00000..
................A.............
