...........0..0....6
....................
.........w..........
.........A...w......
............0.......
..0........0........
..........6.........
.....w..............
