wwwwwwwwwwwwwww.wxwwwwwwww
w...-co-xo.x-........oxooA
w..----.......o.-..ox...xw
w..oxxo........w...o..-..x
w........oo-......b-.b...w
w.--b--..xxxx...x....-ob.w
w..wx.....o....wo.....xo..
w..o...e...e....c..we..xxw
w.....-.......ow-o.o.o.w..
w..w...w...x..xwb-....o..w
....owc..ow-..o--x..-....w
wb..x-e..xx........x.xx...
wwwwwwwwwwwwwwwwwwwwwb..ww
