...0................
..........0.........
..........w.......0.
.........A.......w..
....................
...w............0...
....................
......0.............
