2.2...........0.........0.w...
0.0.2..............w....w.....
000........................w..
.......0.............2........
.0...........w................
..............................
........00.1...........w......
.w..0000.....000000.....00...w
....0000....000..0.1...00.....
...0...00...000....0....0000..
................A......0.....0
