......0......
............w
.............
........0.0..
......A......
.............
.....w.......
..0.0........
