2.0...........0...0.....0.....
0.0................w....w.....
000........................w..
.......0.............2........
.0...........w0...............
..............................
........00.1...........w......
....0000.....000000.....00...0
....0000....000.w0.1...00.....
...0...00...00.w...0....0020..
................A......0.....0
