............0........0........
.00...........................
0.0..................0........
..............................
................0.............
..0........w..................
...............0..........1...
....00...0...000000.....000...
...00000....000000.....00000..
...0...0.....0.....0...00000..
................A.............
