wwwwwwwwwwwwwwwwowwwwwwwww
w..--c-o.we.o..-..co.oxo.w
w..---o....x............xw
w..oxxo....x............ww
w.o......o.oo.....o-x..-.w
w.--b--...xxx.........oc.w
w.-.x..w.....b.x.....oxc-w
x.......w..............xxw
w...o.xox.....ox--.......o
w..A..........x-bo....-..w
w...-o...oo..-.o--.......w
w...xx....x...w......xx..w
wwwwwwwwwwwwwwwwwwwwwwww.x
