...0.........w......
...............w....
..........w.......0.
.........A.......w..
....................
...w................
....................
....................
