..00................
..........0.........
..........w.......0.
.w.......A.......w..
....................
...w.......w........
....................
....................
