1...........w.................
0.0.............0.............
000.......w......0............
.......................1......
..............................
......w...w........0...0.....0
..............................
....000.......000.0.....0w0...
...00000....0000000....00000..
...0...0....00....00...00000..
................A..0..........
