wwwwwwwwwwwww.w.wxwwwwwwww
w...-co-.o.x-........oxooA
w..----x......o.-..ox...xw
w..oxxo........w...o..-..x
w........oo-w.....b-wb...w
w.--b--..xxxx...x....-ob.w
w..wx.....o....wo......e..
w..o...e...o....c..we..xxw
w.....-...x...ow-o.o.o....
wo.w...w...x..xwb-....o..w
....owc..ow-..o--x..-....w
wb..x-e..xx.......cx.xx...
wwwwwwwbwwwwwwwwwwwwwb..ww
