...2........0.................
.00...........................
0.0..0...............0........
..............................
..............................
..0........w..................
1.........................1.0.
....00.......000000.....000...
...00000....00000000...00000..
...0...0.....0....0....00000..
................A.............
