...........0........
....................
.........w..........
.........A..........
............0.......
..0........0........
............w.......
.....w......0.......
