2..............0..........w...
000...........................
0.0...................0.......
...0w......................w..
....0.....001......0.....0....
..............................
.......2......................
....000......000000.....000...
...00........0w.0000......00..
...0...0....0.....00.0.0.000..
...0............A...0.........
