....................
..........w.......w.
.................0..
.........A..........
.......0............
.....ww........0....
....................
.................0..
