wwwwwwwwwwwwwwwwwwwwwwwwwwww
w........w.0......hw...w0..w
w...........ww.............w
w.......0w........w....w...w
w........w.............w..0w
ww............h...w.0..w..hw
w.0ww0...w...w.........w...w
w.......hw.....h..w...0w.w.w
w..A.0............w...w....w
w........h.......0w....1...w
wwwwwwwwwwwwwwwwwwwwwwwwwwww
