........w...........
.....w..............
.........w..0.......
..0......A..........
....................
............w..0....
....................
....................
