.............
w............
w.0..........
........w..0.
......A......
.............
.............
.............
