wwwwwwwwwwwwwwwwwwwwwwwwww
w..--c-o.w..o..-..co.oxo.w
w..----....x...be.......xw
w..oxxo....x............xw
w.o......o.o......o-x..-.w
w.--b--...x.x.o.......oc.w
w.o.x.ow.....b.x.....oxc-w
w......................xxw
wx..o.xox...-..x--.-.....w
w..A....-.....x-bo....-..w
w...-o...oo..-.o.-.......w
w...xx.x..x...w......xx..w
wwwwwwwwwwwwwwwwwwwwwwwwww
