....0.........0.....
....................
....w...ww..........
.........A..........
............0.......
6.0..0.....0........
..........6.........
.....w..............
