1.0....0..........0...........
0.............................
000..............0............
......1................1......
..............................
..........w............0.....0
...........2..2...............
0...00........00000....00w0...
...0.000....0000000....00000..
...0...0....00....00...00000..
...w............A..0..........
