............0....w...0........
.00......................w....
0.0.0................0........
........0.....................
..............................
..0........w..................
..........................1...
....00...0...000000.....000...
...00000....000000....000000..
...0...0.....0....00...w0000..
................A.............
