............0........0........
.00.........0...0.............
..0...............1...........
..............................
..............................
..0........w0.........0.......
..........................12..
....00...0...000000.....00....
...0000.....0000000.0..000002.
...0...0.....0....00....0000..
................A........0....
