....................
......7..0..........
.......0..........w.
.........A..........
.....w..............
....................
...........0......0.
..............0.....
