wwwwwwwwwww.www.wxwwwwwwww
w...-co-xo.x-....b...oxooA
w..----.......o.-..ox...xw
w..oxxob....w..w...o..-..x
w........oo-.......-.b...w
w.-----..xxxx...x....-ob.w
w.ewx.....o....wo.....xo.w
w..o...e...e....c..we..xxw
w.....-.......ow-o.o.o.w..
w..w...w...x..xwb-....o..w
....owc..ow-..o--x..-....w
wb..x-...xx........x.xx...
wwwwwwwwwwwwwwwwwww.wb..ww
