2.........................w...
000...........................
0.0...................0.......
...0w......................w..
....0.....001......0.....00...
..............................
.....0.2......................
.w..000......000000......00...
...00........0w.0000......00..
...0...0....0.....00.0.0.000..
...0............A...0.........
