............0........0........
.00.....0...0........2........
..0..................0..0.....
...............w..............
......................0.......
..0........w.............0....
..............2...........10..
....0....0...00000.......0....
...0000.....000000..0.0000000.
.......0.....0....00....0000..
.2..............A........0....
