10..............6.............
000...........................
00..........................0.
...0..........................
.......0.00........000........
.......0..0........0..0.......
....................A.........
.2............................
..00000....00000000....00000..
..0...0....00....000...00000..
................1.............
