....................
......7..0..........
.....A.0..........w.
....................
.....w..............
....................
...........0......0.
..w...........0.....
