..00................
..........0.........
..........w.......0.
.........A.......w..
....................
...w..........w.....
....................
....................
