2..........w...0..............
000............0..............
0.0...........................
...0w.......0.................
....0......01............0....
..............................
..............................
....000......00.000.....000...
.0.00.00.....00.0000....0.00..
...0...0....0.....0..0.00000..
................A.............
