2........1...00.........0.w...
0.0................w...1w.....
.00..........0.1........0.....
.......0.............2........
.0...........w................
..............................
....02..0001.0.........w......
.0..0000w....00..00......02..0
....0000....00...0.1...00.....
..1....00...000.........0000..
................A......0.....0
