....0.........0.....
.0..................
.........w..........
.........A...w......
....................
6.0........0........
..........6.........
.....w..............
