wwwwwwwwwwwwwwwwwwwwwwwwwwww
w....A...w.0......h.....0..w
w........w..ww.............w
w.w......w........w....w...w
w..h.....w......w.w....w..0w
w........w....h...w.0..w...w
w.0www...w........w....w...w
w........w........w....w...w
w....0............w........w
w.....w..h.......0.h...1...w
wwwwwwwwwwwwwwwwwwwwwwwwwwww
