....0.........0.....
.....6..............
....A....w..........
.........w..........
............0.6.....
6.0........0........
..........6.........
.....w..w...........
