....0.0......
.............
..1..w.......
.............
...0..A......
............1
..w........w.
.............
