1.............................
000...........................
000...........................
........................0.....
....2.........................
.......0......................
.......................0......
....000......000000.....000...
...00000....00000000....0000..
...0...0....00....00...00000..
................A.............
