10..............6.............
000...........................
00................6.........0.
...0..........................
.......0000........000........
.......0..0........0..0.......
..............................
............0.................
..00000....00000000....000.0..
..0...0....00....00....00000..
...............A1.............
