............0........0........
.00............0..............
0.0..................0........
.2........................0...
..............................
..0........w..................
..........................1...
....0........0.0000.....000...
...00000....0.000000...00000..
...0...0.....0....00...00000..
................A.........2...
