....006.......0.....
....................
.........w..........
.........A..........
............0.......
6.0.................
..........6.........
.....w...w..........
