.................3..
..................0.
....0.0.0.0.........
.........A.....w....
...........3........
...............8.0..
.......03...........
...ww...............
