.................0..
......0.............
....0...............
...w.....A..........
..0.................
...............w.0..
....................
....................
