....................
......7..0..........
.......7..........w.
.........A..........
.....w..............
................w...
...........0......0.
.7............0.....
