wwwwwwwwwwwwwwwwwwwwwwwwww
w..--c-.....o......-ooxoow
wo.--o-.........o...x...xw
w..oxx..w.o..............w
w........oooeo....--.-.c.w
w.--b--..xxxx........o..ew
w..x................cxxo.w
w....w............b....-xw
w.....xxx.....o---...oo.ew
w..x....e.....x-bx.o..o..w
w....e...oo....b-x..o....w
w...xx...xA..........xx..w
wwwwwwwwwwwwwwwwwwwwwwwwww
