...........0..0.....
....................
.........w..........
.........A.w.w......
............0.......
6.0........0........
..........6.........
.....w..............
