....................
..........w.......w.
....................
.........A..........
.......0............
......w..0.....0....
....................
.................0..
