wwwwwwwwwwwwwwwwwwwwwwwwwwww
w....A...w.1......h.....0..w
w........w..ww.............w
w........w.....0..w....w...w
w..h.....w........w....w..0w
w.............h...w.0..w..hw
w.0www...w........w....w...w
w........w........w..w.w...w
w....0............w........w
w........h.......0w....1...w
wwwwwwwwwwwwwwwwwwwwwwwwwwww
