202......1...00.........0.w...
0.0................w...1w....0
.0...........0.....0.......w..
.......0.1...........2........
.0...........w................
..............................
........0001.0.........w......
.0..0000.0...00.0.0......0...0
....0000.....0...001...00....0
.......00...000.........0000..
..1.............A............0
