wwwwwwwwwwwwwwwwwwwwwwwwww
w...-c-.x......-..o-ooxoow
we.--o-....o....o--.x...xw
w...xx....o....x.........w
w.w.....-e.oe.x...--c-...w
w.e-b.-..x.xx..o.....oo.ow
w...........x........xxo.w
w..x.ww.......o...-o...-xw
w.....xxx.....o--.....o..w
w...x...e..x..o-bx.x..o..w
w....e...oo....-.o..o.-..w
w...xx....A..........xx..w
wwwwwwwwwwwwwwwwwwwwwwwwww
