wwwwwwwwwwwwwwwwwwwwwwwwwwww
w....A...w.0......h.....0..w
w........w..ww.............w
w.......0w........w....w...w
w........w........w....w..0w
w........w....h...w.0..w..hw
w.0www...w........w....w...w
w.......hw........w...0w...w
w....0............w........w
w........h.......0w....1...w
wwwwwwwwwwwwwwwwwwwwwwwwwwww
