1.............................
0.0...................0.......
000...........................
..........................0...
................0.............
......................1w......
..............................
....000......000000.....000...
...00000....00000000...00.00..
...0...0.....0....00...00000..
................A.............
