...0........w.......
....................
..........w.......0.
.........A.......w.w
....................
...w................
....................
....................
