......0..w...
.0......w..4.
....0........
........0.0..
......A......
.............
.............
..0..........
