wwwwwwwwwwwwwwwwwwwwwwwwww
w..--c-...-.o......-ooxoow
wo.--o-....o....o...x..xxw
w...xx....o..............w
w........oxoe...c.--c-...w
w.--b.-..xxxx..o.....oo.ew
w..x.................xxo.w
w....w....-o..o...-....-.w
w.....xxx.....o---...xo..w
w..x....e.....x-ex....o..w
w....e...oo....-.o-.ob...w
w...wxw..xA..........xx..w
wwwwwwwwwwwwwwwwwwwwwwwwww
