....0.w.......0.....
....................
....w....w..........
.........A..........
............0.......
6.0........0........
..........6.........
.....w............6.
