1......0.................0....
000........0................1.
000..........2.........0......
..............................
...........0....0.............
..............................
.....................0.0......
....0........000000..0..000...
...00000....0.000000...00000..
...0...0....00....00....0000..
w...............A.............
