0....................w........
000...........................
000...........................
..............................
........................0.....
..............................
..............................
....000......000000.....000...
...00000....00000000...00100..
...0...0....00....00...0000...
................A..w..........
