wwwwwwwwwwwwwwwwwwwwwwwwww
w..--c-.....o......-ooxoow
wo.-.o-........eo...x...xw
w..oxx....o..............w
w.w......oooeo....--c-..-w
w.--b--..xxxx........o..ew
w..c..................xo.w
w....w............-....-xw
w.....xxx.....o---.x.oo..w
w..x....e.....x-bx....o..w
w....e...oo....--x..o....w
w...xx...xA..........xx.ow
wwwwwwwwwwwwwwwwwwwwwwwwww
