...........0..0.....
....................
....w....w..........
.........A...w......
.......0....0.....0.
..0....6.0.0........
..........6.........
.....w..............
