1.............................
000........0..................
000...........................
..............................
..............................
.............0................
..............................
....000......000000.....000...
...00000....0000.0.0...00.00..
...0...0....00.A..00...00000..
..........................0...
