wwwwwwwwwwwwwwwwwwwwwwwwww
w..--c-.....o......-ooxo.w
w..--o-....o....oo..x...xw
w...xx....o..............w
w.w......oxoe.....--c-...w
w.--b.-..xxxx..o..b..oo.ew
w..c.................xxo.w
w....w....-o..o...-....-xw
w.....xxx.....o---...xo..w
w..x....e.....x-b.....o..w
w....e...oo....-.o-.o....w
w...xx...xA...x......xx..w
wwwwwwwwwwwwwwwwwwwwwwwwww
