................0...
...0................
07.....7..........w.
.7......0A..........
........w...........
................w.0.
.........w..........
.7....7..7....0.....
