2..............0..........w...
000...........0...............
0.0...................0.......
...0w......................w..
....0.....001......0...0.0....
.........0...............0....
.......2......................
....000......000000.....0.0..0
...0.........0w.0000......0...
...0...0..........00.0.0..00..
...0............A...0.........
