................0...
.........0...w......
.7.....7..........w.
.........A..........
....................
................w.0.
.........w.0......0.
.7....7.......0.....
