wwwwwwwwwwwwwwwwwwwwwwwwww
w..--c-.....o......-ooxoow
wo.--o-....o....o...x...xw
w...xx....o..............w
w.w......oxoe.....--c-...w
w.--b.-..xxxx..o.....oo.ew
w..x.................xxo.w
w....w....-o..o...-....-xw
w.....xxx.....o---...xo..w
w..x....e.....x-bx....o..w
w....e...oo....-.o-.o....w
w...xx...xA..........xx..w
wwwwwwwwwwwwwwwwwwwwwwwwww
