......00.....
.0......w....
....0........
........0.0..
.....0A......
.............
.............
..0..........
