...........0....w...
....................
.........w..........
.........A..........
.......0....0.......
..0........0........
....................
.....w..............
