....................
..........w.......w.
.................0..
.........A..........
........0.......0...
.....ww........0....
.................0..
..0..0....0......0..
