............0........0........
.00............0..............
0.0..................0........
..............................
..............................
..0........w..................
.......................0..1...
....00.......000000.....0.0...
...00000.....0000000...00.00..
0..0...0..........00...00000..
.....0..........A.............
