ww.wwwwwwwwwwwwwwwwwwwwwww
woo........-.....wo..o...w
w---o............b.-e--..w
w..o.xxx....o....o.ox.o.ow
wx.w.....o.o.w...ox.....ow
w..wwwwww.w.......o...wxxw
wb-....o..c.eoe..o.e....xw
w--ow......Ao....o...ewxxw
w.oo.......o.....-...-w.ww
w......x....wwwwx-..oow.ow
w.....xx.o.o....o..xoxx..w
wc--..x..x..o.xxo-....w..w
wwwwwwwwwwwwwowwwwwwwww.ww
