.............0......
......00..........w.
w...................
.........A.w........
...........0........
....................
...................0
......0.............
