wwwwwwwwwwwwwwwwwwwwwwwwwwww
w....A...w.0......h....h0..w
w........w..ww.............w
w.......0w..0.....w....w...w
w........w........w....w..0w
ww.0.....w....h...w.0..w..hw
w.0www...w........w....w...w
w.......hw........w....w...w
w....0................w....w
w................0w....1...w
wwwwwwwwwwwwwwwwwwwwwwwwwwww
