...........0........
....................
....................
.........A.....0....
............0.......
..0.......w0........
............w.......
............0.......
