wwwwwwwwwww.wwwwwxwwwwwwww
w...-co-xo.x-........oxooA
w..----.......o....ox...xw
w..oxxo............o..-..-
w........oo-w...b.b-.b...w
w..-b.-..xxxx...x..-.oo..w
w..wx.w...o..w..o.....xo.w
w..o...e...e....c...e..xxw
......x..x....o.-o.o.o...w
w..w..-w...x..xwb-....o..w
....owc..ow...o--x..-....w
wb..x-e..xx........x.xx...
wwwwwwwwwwwwwwwwwwwwwb.www
