........w...........
..w.................
.0..................
.........A..........
..0.0...............
..........w.......w.
........0...........
....................
