......0.....0
........w....
........w....
........0.0..
......A......
.............
.............
..0..........
