............0........0........
.00...........................
0.0..................0........
..............................
..............................
..0........w..................
..........................1...
....00.......000000.....000...
...00000....00000000...00000..
...0...0.....0....00...00000..
................A.............
