wwwwwwwwwwwwwwwwwwwwwwwwwwww
w....A...w.0.w....h.....0..w
w........w..ww.............w
w.......0w........w....w...w
w........w........w....w..0w
w........w....h...w.0..w..hw
w.0.ww...w........w....w...w
w.......hww.......w...0w..hw
w....0............w........w
w........h.......0w....1...w
wwwwwwwwwwwwwwwwwwwwwwwwwwww
