..........w........0
0...................
..................0.
.........A0.....0...
...0.........w......
....................
....................
.0.....w....0..w....
