....0.0.......0.....
............0......0
..6.w....w..........
.........A..........
....................
6.0........0........
..........6.........
.....w..............
