........w.........0.
....0.....0w....0...
....w0............0.
.....0...A.0........
..w.........0.......
.w......w..w.......0
......0..w..........
.....w....w.......w0
