............0........0...w....
.00.....0...0........2........
...........0.....0...0..0.....
......w........w..............
......................0.......
..0........w..................
..........................10..
....0....0...000000......0....
...0000.....w00000..w.0000000.
...0...0....w0....00....0000..
.2.........1....A........0....
