w.wwwwwwwwwww-w.wxwwwwwwww
w...-co-xo.x-........oxooA
w..---........o.-.-ox...xw
w..oxxo........w...o..-..x
w........oo-x.....b-.b...w
wc--b-...xxxx...x....-ob.w
w..wx.....o....wo.....xo..
w..o...e...e....c..wc..xxw
w.....w.......ow-o.obo.w.w
w..w...w..cx..xwb-....o..w
....owc..ow-..o--x..-....w
wb..x-e..xx......-.x..x...
wwwwwwwwwwwwwwwwwww.wb..ww
