............0........0........
.00...........................
0.0.0................0........
..............................
..............................
..0........w..................
..........................1...
....00...0...000000.....000...
...00000....0000000...000000..
...0...0.....0....00...00.00..
................A.............
