....................
....................
....................
......w..A......w...
.0............w.....
.w..................
...............0....
.........w.........0
