wwwwwwwwwwwwwwwwwwwwwwwwww
w...-c-......x.-...-ooxoow
we.--o-....o....b--.x...xw
w...x.....o........o.....w
w.w.....-oooe.....--c-...w
w.e-b.-..x.xx..o.....xo.ow
w..x........x..x.....xxo.w
w....ww....o......-o...-.w
w.....xxx.....o--.....o..w
w..c....e.....x-ox.xx.o..w
w....e...oo....-.o..o.-..w
w...xx...xA..........xx..w
wwwwwwwwwwwwwwwwwwwwwwwwww
