1.............................
000...........................
000...........................
..............................
.......0000.......10000.......
.......0..0........0..0.......
..............................
..............................
..00000....00000000....00000..
..0...0....00....00....00006..
...............A..............
