.......w........0...
...0.....0..........
.7.....7..........w.
........0A..........
........w.....7.....
................w.0.
.........w..........
.7....7.......0..0..
