wwwwwwwwwwwwwwwwwwwwwwwwwwww
w....A.....0......h.....0..w
w........w..ww.............w
w.......ww..0.....w....w...w
w........w........w..h.w..ww
ww.......w....h...0.0..w..hw
w.0.ww...w........w....w...w
w.......h.........w0..0w...w
w....0...............ww....w
w........h.......0w....1...w
wwwwwwwwwwwwwwwwwwwwwwwwwwww
