....................
......7..0..........
.......7.w........w.
.........A..........
....................
..7.............w...
...........0......0.
.7......7.....0.....
