....................
......0...w.......w.
.................0..
.........A..........
.......00...........
.....ww........0....
....................
..........0......0..
