10........0.....6....6........
000...........................
00............................
...0..........................
.......0000........000........
.......0..0........0..0.......
..............................
..............................
..00000....00000000....00000..
..0...0....00....00....00000..
...............A1.............
