202......1..100..w......0...2.
0.0...........0....w0..1w.....
.00..........0.1..............
.......0.............2........
.0...........w................
.......w......................
........0.01.0.........w......
.0..0000.....00..00...2..0..00
.....0.0....00...0.1...0......
..1....00....00.........0000..
.......00.......A......0.....0
