.....................0........
000...........................
0.0..................0........
...0..........................
..............................
..............................
..........................1...
....000......000000.....000...
...00000.w..00000000...00000..
...0.........0....00...00000..
................A.............
