......0......
.0......w....
....0........
.....4..0.0..
.0....A......
.............
.............
..0..........
