....0.0......
.............
..1..w.......
.............
......A......
............1
.............
..........w..
