wwwwwwwwwwwwwwwwwwwwwwwwww
w..--c-.....o......-ooxoow
wo.--o-.........o.......xw
w..oxx....o............c.w
w.x......oooeo....--w-...w
w.--b--..xxxx.x......oo.ew
w..x.................xxo.w
w....w............-....-xw
w.....xx....o.o---...oo..w
w..x....e.....x-bx....o..w
w....e....o....--x..o....w
w...xx...xA...........x..w
wwwwwwwwwwwwwwwwwwwwwwwwww
