...........0..0.....
............0.......
.........w..........
.........A...w......
6...........0.......
6..........0w.......
..........6.........
.....w..............
