...........0..0.....
....................
.........w...0......
.........A...w......
............0.......
6.0.................
..........6.........
.....w..............
