wwwwwwwwwwwwwwwwwwwwwwwwww
w..--o-............-ooxoow
we.--o-....o......-.x...xw
w...xx....o..x...........w
w.w.....-oxoe.....--c-...w
w.--b.-..xxx...o.....oo.ow
w..x........x........xxo.w
w....w.....o..o...-o...-xw
w.....xxx......--....oo..w
wo.x....x.....x-bx....o..w
w....e...oo....-.o-.o....w
w...ex...xA..........xx..w
wwwwwwwwwwwwwwwwwwwwwwwwww
