...........0........
....................
....................
.........Aw.........
0...................
..0........0........
............w.......
............0.......
