wwwwwwwwwwwwwwwwwwwwwwwwwwww
w....A...w.0......h.....0..w
w........w..ww........0....w
w........w........w....w...w
w........w........w....w..0w
w..0.w...w.0..h...w.0..w..hw
w.0www...w........w....w...w
w....w..hw.w......w....w...w
w....0h...............w....w
w........h.......0.....1...w
wwwwwwwwwwwwwwwwwwwwwwwwwwww
