wwwwwwwwwwwwwwwwwwwwwwwwww
w...-c-........-...-ooxoow
we.--o-....o....o--.x...xw
w....x....o...-..........w
w.w.....-.xoe.....e-c-...w
w.e-b.-..x.xx.xo.....oo.ow
w..x.x......x........xxo.w
w....ww....o..o...-o...-xw
w....oxxx.....o--.....o..w
w..x....e......-bx.x..o..w
w....e...oo....-.o..o.-..w
w...xx...xA..........xx..w
wwwwwwwwwwwwwwwwwwwwwwwwww
