................0...
...0.....0.......0..
.7.....7..........w.
........0A..........
........w...........
.....w7.........w...
.....3...w..........
.7.......0..........
