......0......
.............
.....w....w..
........w....
.....0A......
...0.........
.............
......0......
