....0.........0.....
....................
....w....w....w.....
.........A..........
............0.......
660........0........
..........6.w.......
.....w..............
