..............0.....
....................
.........w..........
.........A...w......
............0.......
6.00.......0........
..........6.........
.....w..............
