1.............................
000...........................
000..............0............
.......................1......
..............................
.......................0.....0
..............................
....000.......00000.....0w0...
...00000....0000000....00000..
...0...0....00....00...00000..
...w............A..0..........
