wwwwwwwwwwwwwwwwwwwwwwwwww
w..--c-............-ooxoow
we.--o-....o....o.-.x...xw
w...xx....oo.............w
w.w.....-cxoe.....--c-..-w
w.--b.-..xx.x..o.....oo.ow
w..x.....x..x........xxo.w
w....w........o...-o...-xw
w.....xxx..x..o.-.....o..w
w..x....e.....x-bx....o..w
w...oe...bo....-.o-......w
w...xx...xA..........xx..w
wwwwwwwwwwwwwwwwwwwwwwwwww
