wwwwwwwwwwwwwwwwwwwwwwwwww
wo...............wo..o...w
w---..e..........b.----.ww
w....xxx....o....o.ox.o.ow
wx.w.....o.o.....ox....oow
ww.wwwowww......x.o...wxxw
wb-...co....eoe..o....w..w
w--........Ao....o...e.xxw
wooo....-..o.e...-...-w..w
w......x....wwwwx.x.oow.ow
w...o.xx.o.o....o..x.xx..w
wc--...o.x..owxxo-....w..w
wwwwwwwwwwwwwwwwwwwwwwwwww
