................0...
..A0.....0..........
.7.....7..........w.
........0...........
........w...........
.......0........w.0.
.........w..........
.7....7.............
