2..........w...0..............
000...........................
0.0...........................
...0w......................w..
....0......01............0....
..............................
.......2......................
....000......000000.....000...
...00.00.....0w.0000....0.00..
...0...0....0.....00.0.00000..
................A...0.........
