............0........0........
.00.........0.................
..0..................0..0.....
...................0..........
............2.................
..0........w..................
..........................1...
....00...0...0000000.0..00....
...0000.....0000000.0.0000000.
...0...0.....0....00....00.0..
................A........0....
