2..............0..........w...
000...........................
0.0...................0.......
...0w.......0..............w..
.A..0.....001......0.....0....
..............................
.......2......................
....000......000000.....000...
...00........01..000......00..
...w...0....0.....00.0.0.000..
...0................0.........
