............0........0........
.00.........0.................
..0..................0..0.....
..............................
..............................
..0........w..................
..........................1...
....00...0...000000.....00....
...0000.....0000000.0.0000000.
...0...0.....0....00....0000..
................A........0....
