2.............................
00........0.........00........
00..................00........
.......00...............00....
.......00..00...........00....
..00.......00.................
..00............00............
...............00000..........
...........0..000000..........
..............0000...........0
...........A.................1
