..............................
........................00....
........................00....
.......0........000...........
.......0........000...........
..............................
...00......0000...............
...00......00000..............
............0000.......000....
.......................000....
A.............................
