..............................
..00000000..00................
..0000..00..00................
...00.................00......
......................00......
..............................
..............................
00...........00...............
20...........00....00......000
2..................00......0..
A.............................
