..............................
..............................
........00....................
...00...00....................
...00..........00.............
...............00.............
............00..........00....
............000.....00..00....
.............000....000.......
..............00......0.......
....................A.........
