..............................
00.........00.................
00.........00.................
..............000.............
..00..........000......00.....
2000.................0000.....
20...................000......
00........................00..
..........................00..
..............................
...A..........................
