.11...........................
..00000.......................
......0........000............
...............000............
........0.....................
.............00......00.......
.............00......00.......
................00.........000
000.............00.....00..0..
..0....................00.....
................A.............
