2.............................
0...........00................
............00.......00.......
..00.................00.......
000..00.......................
.....00.......................
.................000........00
.......00........000..0.......
.......00.....................
..............................
A.............................
