.2............................
000......00...........00......
000......0000.........00......
....0000...00.................
....0000............00........
.....................0........
..............................
000....................00.....
.......00.......00....000.....
.......00.......00....00......
A.............................
