..............................
000......00...................
..0......00.....00.......00000
................00.......00...
..............................
........00000000...00.........
...............0...00.........
..............................
........00..00................
........00..00................
.............................A
