2.............................
00..00.................00.....
....00............00...00.....
..................00..........
......00.......00.............
.....000.......00.............
.....00.............00........
............0.......00........
.........................00...
.........................00...
A............................2
