2.............................
000.......................00..
000........00..00........000..
...........00..00........00...
.........00...................
000......00...................
..0....00.....................
......000..........000........
......0............000....00..
..........................00..
....................A.........
