........................2.....
................0000000000....
.........000....000....00000..
.........000...............0..
....................00........
....................00........
........000...................
........0000..................
..........00........0...000...
....................0...000...
.............................A
