2.............................
00............................
00............00..00..........
..............00..00..........
........00...................0
.......000...................2
.......00....................1
..000...................000..0
..000....00......00.....000...
.........00......00...........
A.............................
