..............................
..............................
...000000000......0000....00..
..000......000....0..0....00..
0000.........0................
..............................
.........000...000............
.........000...000............
......00......................
......00......................
.............................A
