1.............................
00......................00....
00.........00...........00....
...........00...00...00.......
...............000...00.......
...........................000
0000.......................0..
..00...........00....00.......
...............00...000.......
....................0.........
A.............................
