..............................
..........................00..
..........................0000
....00.....................0..
....00..............0000......
....................00000.....
.......0000...........000.....
.......000000.............00..
.........0000.............00..
..............................
A.............................
