1.............................
000.......00000...............
000......000000...............
.........00000................
..............................
..000................00.......
..000................00.......
...........00.................
.....00....00....00.....00....
.....00..........00.....00....
A.............................
