2.............................
00............000.............
10......00....000.............
........00........00..........
..................00..........
.......................00.....
.......................00.....
...............00.............
..........00...00.............
..........00..................
...............A..............
