2.............................
00.........00.........00......
00.........00.........00......
..........................00..
..00......................00..
..00......000.................
..........000....000..........
.....00..........000..........
.....00.......................
..............................
2....A........................
