1.............................
10............................
...00.........................
...00.........................
..............................
..............................
...00....0000.........0000....
...00...00000000.....00000....
........00000000.....0000.....
............00................
A.............................
