1.............................
00000...00.........00.........
........00...00....00.........
.............00...............
..............................
..............................
.......00..00...00............
.......00..00...00............
..00.................00.......
..00.................00.......
.............................A
